ROOMS: 11
MONSTER: 10 420000
BREWERY: 5 5
ARCS
ARC: 1 1 2
ARC: 1 1 3
ARC: 1 1 4
ARC: 1 1 5
ARC: 1 1 6
ARC: 1 1 7
ARC: 1 1 8
ARC: 1 1 9
ARC: 1 1 10
ARC: 2 1 1
ARC: 2 1 3
ARC: 2 1 4
ARC: 2 1 5
ARC: 2 1 6
ARC: 2 1 7
ARC: 2 1 8
ARC: 2 1 9
ARC: 2 1 10
ARC: 3 1 1
ARC: 3 1 2
ARC: 3 1 4
ARC: 3 1 5
ARC: 3 1 6
ARC: 3 1 7
ARC: 3 1 8
ARC: 3 1 9
ARC: 3 1 10
ARC: 4 1 1
ARC: 4 1 2
ARC: 4 1 3
ARC: 4 1 5
ARC: 4 1 6
ARC: 4 1 7
ARC: 4 1 8
ARC: 4 1 9
ARC: 4 1 10
ARC: 5 1 1
ARC: 5 1 2
ARC: 5 1 3
ARC: 5 1 4
ARC: 5 1 6
ARC: 5 1 7
ARC: 5 1 8
ARC: 5 1 9
ARC: 5 1 10
ARC: 6 1 1
ARC: 6 1 2
ARC: 6 1 3
ARC: 6 1 4
ARC: 6 1 5
ARC: 6 1 7
ARC: 6 1 8
ARC: 6 1 9
ARC: 6 1 10
ARC: 7 1 1
ARC: 7 1 2
ARC: 7 1 3
ARC: 7 1 4
ARC: 7 1 5
ARC: 7 1 6
ARC: 7 1 8
ARC: 7 1 9
ARC: 7 1 10
ARC: 8 1 1
ARC: 8 1 2
ARC: 8 1 3
ARC: 8 1 4
ARC: 8 1 5
ARC: 8 1 6
ARC: 8 1 7
ARC: 8 1 9
ARC: 8 1 10
ARC: 9 1 1
ARC: 9 1 2
ARC: 9 1 3
ARC: 9 1 4
ARC: 9 1 5
ARC: 9 1 6
ARC: 9 1 7
ARC: 9 1 8
ARC: 9 1 10
ARC: 10 1 1
ARC: 10 1 2
ARC: 10 1 3
ARC: 10 1 4
ARC: 10 1 5
ARC: 10 1 6
ARC: 10 1 7
ARC: 10 1 8
ARC: 10 1 9
ARC: 10 1 11
